################################################################
#..............................+...............................#
#..............................#...............................#
#.................X............#...............................#
#....>.........................#.......X.......................#
#..............................#...............................#
#..............................#...............................#
#.................<............#...............................#
#..............................############....................#
#...................................#..........................#
#...................................#..........................#
#.............###+####..............#...........X..............#
#......X......#......#..............#..........................#
#.............#......#.........................................#
#.............#$$..$$#..............#..........................#
#.............########..............#..........................#
#...................................#..........................#
#...................................#..........................#
################################################################