================================================================================================================================
================================================================================================================================
================================================================================================================================
================================================================================================================================
================================================================================================================================
================================================================================================================================
================================================================================================================================
================================================================================================================================
================================================================================================================================
================================================================================================================================
================================================================================================================================
================================================================================================================================
================================================================================================================================
================================================================================================================================
================================================================================================================================
================================================================================================================================
================================================================================================================================
======================#=========================================================================================================
================================================================================================================================
=============================================================#==================================================================
================================================================================================================================
================================================================================================================================
=============================================================#....==============================================================
===========================================================#......==============================================================
==========================================================#.......=====================##=======================================
===============================================..========##.....##======#.=============##=======================================
==========================##==================....====##==##....##======...============##=======================================
=========================..#.==========###====....#######===....##======.....==========#========================================
=========================#....========####======...##  ###==....##=======......=======..========================================
============#============#....=======## #==##====...####.==#.....#.....=.....##=====#...========================================
============##====...====.....=======## #=###.====.......==###...........==.########..==========================================
============##.==##...===###..========# ### #...==.......==# ##..........==..##   ##.===========================================
=============.........==..#..=========####  #............###  ##.......##===..## ##..===========================================
======.=========..#...==..#..===========.#  #...######..##     ############==..# #..============================================
=====...===#====..#...==.......##==###...## #####    #.######          ##......# #.=============================================
.====..#===#########...........##### #....##       ###..##..##       ###.......###......========================================
..===.##==##       #.............#   ###...#       #.........####    #..............#.......====================================
#..==.##==#        #...#.........#    ##...#####   #...#........#    #........###...##....#..==================================#
##..=..#==#        #.......#.....#   ##.....#..##  ##.##........#    ##........###..########..=================================#
 ##....########    #.....###.....#  ##..........#  #...####.....#     ##.......# ####   ####..===============================###
  ##...#####..#    #....####.....# ##...........####...#  ##....#    ##........#     ####====.=======================.#======#  
###...........# #####..####......# #.................###   ###..#    #.........####  #..=====.=======================.##=====#  
#.............# #..#..####......####.................#       ####    #............# ##.....=..======================...##===##  
#............## #....## #........##.................##               ##...........###..........====================..=..####### 
#.......#.....# #....#  #........##....#####.......##  ####### ####   #............##............=================..===....#..##
#......###....# ######  ##......##...###   #...#####  ##.....###..##  ##########...##.....######.==========..============.......
#.....#####...###        #.........###     #####      #........#...#           #########...#   #..=======...#=============......
#.......###.....#      ####.......##     ####    ######............#                 ##..#.##  ##.........####============......
#...............#  #####..#...##...###  ##..###  #....#####........#                 #......#   ########..#  #===========.......
##............###  #........######...####.....#  #.....#  ##......##     ####       ##......#      ######.####===###====#.......
##..........#..#   #........#   ##...##.......#  ##....#  ##.....##      #..#   #####.......#      #..##...#...=....#==####.####
#.......##.....#####........#  ##.....#.......#  ##....#  #.....##      ##..#####........###########.............#..#######.##  
......###......##..#....##### ##...##.......###  #.....####.....#       #................#  ##..#..........#........#....##..## 
....### #..####.........#     #....###........#  #...#.#.....#..#       #......#........##  #.......#.......#............##...##
##..#   ##...#...##....##   ###.....####......#  ####.......##..#       #..######.......##  #............##......#...#####.....#
 ####  ##....#......#### ####.......## ##....##    ##......###..###     #..#    ##.......## ##........#####......#####   #.....#
       #............#    #...........## ##..###    #......## ##...##   ###.##    ##.......#  #.......##   ###.....##     ###...#
       #...##.......#    #......##....###.....#    #......#  ##....##  #....##    ##......#  ###......###   ####...#     ##...##
###    #...###.....##    ##.......##..........##   #......#  #......# ##.....###   #......#    ##.......#     ##...#######....# 
..##   #..## ##....#     #..####..##...........#   #......# ##......###........#   #.....##     ####....#     #.....#........## 
...## ##..#   ############..#  #####...........######...### #..................#   #..####    ####......#     #.........####..# 
....###..##      ##.........#      ##......#...........######..................#   #### #######......####     #........#####..# 
.........#       #..........#       ###...###.......#####..##.......#.........##        #............#        #.......## #...## 
####.....#       #........###         ##..# ##......#   #..........####.....###         #...###......#        ####....#  #..##  