                                                                                                                                
                                                                                  #####                                         
                                   ##### ############################           ###...####                                      
                                   #...###..........##..............###         #........#                                      
                                   #...##.............................#         #........#                        #######       
                                 ###......######......................#         ##.......#     #######        #####.....#       
   ####                    #######.........#   ##............=====....##       ##........# #####.....#        #.........#       
   #..##             #######...............#    #..........=======.....###### ##..##.....###.........#        #........##       
  ##...#####         #...##................#    #..........#####==.....##...###...###.....##.........##       ###......##       
  #........# ####   ##.........#.........###    #....##...=#   ###..#####....#...###......##..........###       #.......#       
  #........# #..#   #.........###....#####      #######...=#     ####   ##........##.......#............#       ##......######  
  #........# #..#####.......### #...##                #...=##            #........###...................####   ##.........#..#  
  ##.......# #.............##   #####                 ##...=####      ####.........####....................#####.............#  
   #......## #.............#                           #...====###    #............#  #....................##.........#......#  
   #.....##  #.............#                           #.....=...#   ##............## #####...............###........####....#  
   ##...##   ####.......#### ##### #####               #.........#   #...##.........#     ##........................#######..#  
   ##....#      #.......##  ##...# #...# #########  #####........#   #...###........#####  ##..........####.........###......#  
  ##.....#     ##........####....###...###.......####..#######.###   #...##..........#..### ##........##  ###..##....#......##  
  #.....##     #.................##....##..............#   ###.#   ###...#................#  ###..#####     #####............#  
  #.....#      #.................#.....##..............#   #...#  ##......................#    ##.##            #............#  
  #....##      #....#........#........###.............##   #...#  #.......###.............#     #..#           ##............#  
  #....#       ######.......###......##.............###   ##...#  #......## #.............##    ##.#           #.............#  
  #....#            #.......# ##....###...#........##   ###....#  #.....### ##.............#     #.#           #............##  
  #...###           #.......#  ##..###....##.......#    #...####  #..#....#####.....###....#    ##.####        #...........##   
  #.....#    #####  ##.....##  ##### #............###   #...#     #..##.....# #....## ######   ##.....###      ###......####    
  #.....##   #...#   #.....#  ##..## #..............##  ##..#     #..###....####..##           #........#     #####.....#       
  #......#   #...#   ##....#  #....###...............########     #### ##....##...#         ####........#     #..##.....#       
  ##.....#####...#    ##...#  #...........................#             #.........#        ##...........##    #........##       
   ##.....##.....######....####...........................#          ####.........#        #.............#    ##.....###        
    #..#...........##....................................##      #####...........##        #.............#     #.....#          
    ##..............................#...........###.....##     ###..##...........#         #.............#     #.....#          
     #...........#..................##........### ###...####   #.....#.##........##        #.............#     #.....#          
     #..........##.......#.........####.......#     #......#####.......####.......###      ##...........##    ##...###  ####    
     ##.......####..######.........# ##......##     #..................#  ###.......##      ##.........##     #..###  ###..###  
      ##......#  ####    #........## #.......#      #................###    ###......##      ##........#      #..#    #......#  
       ######.#          #........####...#####      #...............##        ##......#       #........#      #..#   ##......#  
            #.#          #..........#....#          ##...............##        #......#       #......###      ##.## ##.....###  
            #.####       ####...........##       ####....##...........#        ########       ####..##         #..###......#    
            #....#          #........#..#     ####.....####...........#                          #..#         ###.##......##    
            #....#          ##.........##     #.......##  ##..........#####                      #..#         #.......#....#    
           ##....#           #....###...#    ##.......#    ##.............#                    ####.#         #.....######.#    
      ######.....#           #.....###..#### #........#######..........##.#                    #....#  ####   #....##   ##.#    
      #..........#     #########...........###.......##..##............##.###                  #...#####..##  #....#    #..##   
      #..........#    ##....#  #####.................##.............#####...##############     #...##......#  ##..##    #...#   
      #.........##   ##.....##     ##................##............##   #................##    #...........##  #..#     #...#   
      #.........#    #.......##     ##..............####..........##    ##................#    #............#  ####     #...#   
      ##........#    #........##     ###..........### #...........#      ##...............#    #............#           #####   
       #####....#    ##........#       ##........##   #...........#       ##.#######.....##    ##...........##                  
           ###..###   ##.......######## ##..######    #...........#        #.#     #.....#     #####.........#                  
            ##....##   #..............#  ####         #..........##        #.##    #.....#     #..##.........#      ##########  
            #......#   ####...........#               #....##..###        ##..#    ###...#    ##.............#     ##..#.....#  
      #### ##......#      ##.........##    ############....#####          #...#      #####   ##..............#    ##.........#  
      #..###.....###       #..........##   #.........##....#     ##########...###           ##..............##   ##.........##  
      #.........##         #...........#   #...........#..##     #..............##          #........#......#    #..........#   
    ###.........#          ##..........#   ###......##...##      #.......##......##         #.......###.....#    #..........#   
    #...........#          ##..........###   ###..####..##       #.......#........#         ###.............#    #..........#   
    #.......#####         ##.............#     ##.#  ##..#       #.......#........#           ###...........#    ##........##   
    #......##          ####..###.........#####  #.##  ##.###     #.......####....##             ####........#######........#    
    #.....##           #....## ##.......##...####..#   #...#     ##.....##  ##...#                ##......................##    
    ##..###            #..###   #..........#.......#   #...#      #....##    #####                #.........#######.....###     
     ####              ####     #..........###.....#   #####      ######                          #....######     ###..##       
                                ####...##### #######                                              ######            ####        
                                   #####                                                                                        
                                                                                                                                