######################################################################
#...................##===#.>.#===##..................................#
#....................#===#...#===#...................................#
#....................#===##.##===#...................................#
#....................#====#.#====#...................................#
#........#####.........#===.===#.....................................#
#........#...#...........#=.=#.......................................#
#........#...#............=.=........................................#
#........##+##.......................#######.........................#
#........................<...........#.....#.........................#
#....................................+.....#.........................#
#....................................#.....#.........................#
#....................................#######.........................#
#....................................................................#
######################################################################